NO sprites/wall_01.xpm
SO sprites/wall_02.xpm
WE sprites/wall_03.xpm
EA sprites/wall_04.xpm

F 220,100,0
C 225,30,0

11111111111111111111111111111
1000111000110000000000001
1011000001110000000000001
1001000000000000000000001
10000000001100000111011111111111
111111111011000001110000011111111
11111111000110000011101111111111111
100000000011000001110111111111111
10000000001100000111011111111111
11110111111111011100000010001
1111011111111101110101001W001
1100000011010101100000010001
10000000000000001100000010001
10000000000000001101010010001
110000011101010111110111100111
1011011111101011011110100011
111111111111111111111111111111
