NO sprites/wall_1.xpm
SO sprites/wall_2.xpm
WE sprites/wall_3.xpm
EA sprites/wall_4.xpm

F 220,100,0
C 225,30,0

111111111111111
1000000N0000001
111111111111111
