NO ./res/img/wall_0.xpm
SO ./res/img/wall_1.xpm
WE ./res/img/wall_2.xpm
EA ./res/img/wall_3.xpm

F 0,0,0
C 255,0,0

11111111111111
10000000000101
10101010000001
10000000000101
11D1D1111111D1
11000000000001
10000000000101
10000000000001
10000000000001
10000000000001
10000000000001
10S00000000001
10000000000001
11111111111111
