NO ./res/wall/wall_0.xpm
SO ./res/wall/wall_1.xpm
WE ./res/wall/wall_2.xpm
EA ./res/wall/wall_3.xpm

C 255,0,0
F 0,0,0

                111111111111111111111111
                100000000000000000000001
                100000DD0000000000000001
                100000000000000000000001
                100000000000000000000001
                100000000000000000000001
1111111111111111100000000011111111111111
10000000000000000000000001
10000000000000000000000001
100000000000000000000000011
10000000000000000000000001 11
10000000000000000000000001  11
10000000000000000000000001
10000000000000000000000001
11111100000111111100000111
11111100000111111100000111
11111100N00111111100000111
11111100000001111100000001
11111111111111111111111111

