
NO ./res/wall/wall_0.xpm

WE ./res/wall/wall_2.xpm

SO ./res/wall/wall_1.xpm







F     220,0,0
C 0, 0, 0





111111111111111
100000000000000
111111111111111
