NO ./res/wall/wall_0.xpm
SO ./res/wall/wall_1.xpm
WE ./res/wall/wall_2.xpm
EA ./res/wall/wall_3.xpm

F 25,25,25
C 0,0,20

11111111111111111111111111111111111111111111
1    1100DD0011000111     100DD0000000000001
1    1100110011000001     100110000000000001
1    11001100110010001    100110011111111001
1    110011DD1100110001   10011001      1001
1    1100110011001 10001  10011001      1001
1    1100110011001  10001 10011001      1001
1    1100110011001   1000110011001      1001
111111100110011001    100010011001      1001
10S011100110011001     10000011001      1001
110001000110011001      10000110011111111001
1 1000000110011001       1000110000000000001
1  100001 100DD001        100110000000000001
11111111111111111111111111111111111111111111
